Date,Week,Open PR Count,Closed PR Count,Closed Today,Opened Today,Net Debt
2017-1-1,0,77,11472,11472,11549,77
2017-1-2,1,79,11481,9,11,2
2017-1-3,1,84,11495,14,19,5
2017-1-4,1,82,11517,22,20,-2
2017-1-5,1,75,11544,27,20,-7
2017-1-6,1,81,11574,30,36,6
2017-1-7,1,64,11626,52,35,-17
2017-1-8,1,70,11635,9,15,6
2017-1-9,2,75,11643,8,13,5
2017-1-10,2,91,11659,16,32,16
2017-1-11,2,77,11698,39,25,-14
2017-1-12,2,91,11715,17,31,14
2017-1-13,2,89,11738,23,21,-2
2017-1-14,2,87,11769,31,29,-2
2017-1-15,2,93,11772,3,9,6
2017-1-16,3,104,11773,1,12,11
2017-1-17,3,111,11778,5,12,7
2017-1-18,3,54,11853,75,18,-57
2017-1-19,3,52,11880,27,25,-2
2017-1-20,3,50,11902,22,20,-2
2017-1-21,3,55,11920,18,23,5
2017-1-22,3,56,11928,8,9,1
2017-1-23,4,58,11934,6,8,2
2017-1-24,4,70,11945,11,23,12
2017-1-25,4,73,11960,15,18,3
2017-1-26,4,85,11973,13,25,12
2017-1-27,4,102,11979,6,23,17
2017-1-28,4,110,11987,8,16,8
2017-1-29,4,111,11995,8,9,1
2017-1-30,5,112,11998,3,4,1
2017-1-31,5,110,12013,15,13,-2
2017-2-1,5,129,12015,2,21,19
2017-2-2,5,142,12018,3,16,13
2017-2-3,5,152,12020,2,12,10
2017-2-4,5,117,12070,50,15,-35
2017-2-5,5,125,12073,3,11,8
2017-2-6,6,132,12075,2,9,7
2017-2-7,6,121,12101,26,15,-11
2017-2-8,6,120,12123,22,21,-1
2017-2-9,6,127,12132,9,16,7
2017-2-10,6,92,12176,44,9,-35
2017-2-11,6,92,12200,24,24,0
2017-2-12,6,99,12200,0,7,7
2017-2-13,7,113,12200,0,14,14
2017-2-14,7,123,12213,13,23,10
2017-2-15,7,127,12225,12,16,4
2017-2-16,7,142,12240,15,30,15
2017-2-17,7,156,12245,5,19,14
2017-2-18,7,154,12267,22,20,-2
2017-2-19,7,156,12267,0,2,2
2017-2-20,8,157,12273,6,7,1
2017-2-21,8,176,12277,4,23,19
2017-2-22,8,173,12290,13,10,-3
2017-2-23,8,191,12300,10,28,18
2017-2-24,8,209,12311,11,29,18
2017-2-25,8,215,12320,9,15,6
2017-2-26,8,220,12322,2,7,5
2017-2-27,9,228,12325,3,11,8
2017-2-28,9,253,12327,2,27,25
2017-3-1,9,264,12328,1,12,11
2017-3-2,9,266,12340,12,14,2
2017-3-3,9,285,12341,1,20,19
2017-3-4,9,294,12341,0,9,9
2017-3-5,9,297,12341,0,3,3
2017-3-6,10,304,12344,3,10,7
2017-3-7,10,286,12380,36,18,-18
2017-3-8,10,282,12415,35,31,-4
2017-3-9,10,249,12461,46,13,-33
2017-3-10,10,166,12556,95,12,-83
2017-3-11,10,97,12641,85,16,-69
2017-3-12,10,101,12650,9,13,4
2017-3-13,11,106,12653,3,8,5
2017-3-14,11,103,12675,22,19,-3
2017-3-15,11,106,12689,14,17,3
2017-3-16,11,114,12694,5,13,8
2017-3-17,11,125,12698,4,15,11
2017-3-18,11,135,12704,6,16,10
2017-3-19,11,143,12705,1,9,8
2017-3-20,12,144,12711,6,7,1
2017-3-21,12,108,12765,54,18,-36
2017-3-22,12,68,12823,58,18,-40
2017-3-23,12,47,12866,43,22,-21
2017-3-24,12,48,12882,16,17,1
2017-3-25,12,40,12915,33,25,-8
2017-3-26,12,52,12916,1,13,12
2017-3-27,13,61,12916,0,9,9
2017-3-28,13,49,12948,32,20,-12
2017-3-29,13,47,12981,33,31,-2
2017-3-30,13,49,13010,29,31,2
2017-3-31,13,53,13031,21,25,4
2017-4-1,13,65,13049,18,30,12
2017-4-2,13,70,13050,1,6,5
2017-4-3,14,79,13051,1,10,9
2017-4-4,14,96,13053,2,19,17
2017-4-5,14,136,13062,9,49,40
2017-4-6,14,145,13065,3,12,9
2017-4-7,14,155,13074,9,19,10
2017-4-8,14,164,13080,6,15,9
2017-4-9,14,173,13084,4,13,9
2017-4-10,15,177,13086,2,6,4
2017-4-11,15,178,13106,20,21,1
2017-4-12,15,190,13126,20,32,12
2017-4-13,15,206,13135,9,25,16
2017-4-14,15,209,13144,9,12,3
2017-4-15,15,212,13164,20,23,3
2017-4-16,15,221,13164,0,9,9
2017-4-17,16,228,13164,0,7,7
2017-4-18,16,92,13325,161,25,-136
2017-4-19,16,92,13346,21,21,0
2017-4-20,16,110,13375,29,47,18
2017-4-21,16,96,13406,31,17,-14
2017-4-22,16,99,13417,11,14,3
2017-4-23,16,106,13419,2,9,7
2017-4-24,17,122,13419,0,16,16
2017-4-25,17,140,13426,7,25,18
2017-4-26,17,133,13449,23,16,-7
2017-4-27,17,118,13489,40,25,-15
2017-4-28,17,122,13507,18,22,4
2017-4-29,17,125,13524,17,20,3
2017-4-30,17,132,13527,3,10,7
2017-5-1,18,138,13527,0,6,6
2017-5-2,18,94,13590,63,19,-44
2017-5-3,18,106,13600,10,22,12
2017-5-4,18,83,13650,50,27,-23
2017-5-5,18,58,13694,44,19,-25
2017-5-6,18,62,13719,25,29,4
2017-5-7,18,67,13719,0,5,5
2017-5-8,19,70,13720,1,4,3
2017-5-9,19,88,13720,0,18,18
2017-5-10,19,110,13723,3,25,22
2017-5-11,19,122,13727,4,16,12
2017-5-12,19,144,13728,1,23,22
2017-5-13,19,154,13731,3,13,10
2017-5-14,19,158,13734,3,7,4
2017-5-15,20,164,13734,0,6,6
2017-5-16,20,163,13756,22,21,-1
2017-5-17,20,162,13775,19,18,-1
2017-5-18,20,174,13786,11,23,12
2017-5-19,20,178,13809,23,27,4
2017-5-20,20,167,13838,29,18,-11
2017-5-21,20,169,13841,3,5,2
2017-5-22,21,177,13841,0,8,8
2017-5-23,21,169,13867,26,18,-8
2017-5-24,21,188,13871,4,23,19
2017-5-25,21,201,13872,1,14,13
2017-5-26,21,207,13875,3,9,6
2017-5-27,21,227,13877,2,22,20
2017-5-28,21,236,13878,1,10,9
2017-5-29,22,250,13878,0,14,14
2017-5-30,22,278,13881,3,31,28
2017-5-31,22,290,13886,5,17,12
2017-6-1,22,261,13936,50,21,-29
2017-6-2,22,137,14076,140,16,-124
2017-6-3,22,88,14148,72,23,-49
2017-6-4,22,93,14152,4,9,5
2017-6-5,23,85,14167,15,7,-8
2017-6-6,23,73,14202,35,23,-12
2017-6-7,23,63,14235,33,23,-10
2017-6-8,23,69,14248,13,19,6
2017-6-9,23,65,14284,36,32,-4
2017-6-10,23,81,14287,3,19,16
2017-6-11,23,73,14299,12,4,-8
2017-6-12,24,67,14312,13,7,-6
2017-6-13,24,72,14327,15,20,5
2017-6-14,24,87,14331,4,19,15
2017-6-15,24,96,14348,17,26,9
2017-6-16,24,66,14407,59,29,-30
2017-6-17,24,54,14444,37,25,-12
2017-6-18,24,57,14446,2,5,3
2017-6-19,25,61,14447,1,5,4
2017-6-20,25,71,14459,12,22,10
2017-6-21,25,44,14507,48,21,-27
2017-6-22,25,52,14527,20,28,8
2017-6-23,25,44,14565,38,30,-8
2017-6-24,25,51,14582,17,24,7
2017-6-25,25,54,14591,9,12,3
2017-6-26,26,56,14600,9,11,2
2017-6-27,26,46,14640,40,30,-10
2017-6-28,26,47,14677,37,38,1
2017-6-29,26,53,14696,19,25,6
2017-6-30,26,39,14743,47,33,-14
2017-7-1,26,58,14751,8,27,19
2017-7-2,26,64,14753,2,8,6
2017-7-3,27,71,14754,1,8,7
2017-7-4,27,96,14763,9,34,25
2017-7-5,27,102,14779,16,22,6
2017-7-6,27,113,14797,18,29,11
2017-7-7,27,106,14831,34,27,-7
2017-7-8,27,99,14864,33,26,-7
2017-7-9,27,113,14865,1,15,14
2017-7-10,28,127,14867,2,16,14
2017-7-11,28,116,14903,36,25,-11
2017-7-12,28,131,14919,16,31,15
2017-7-13,28,132,14954,35,36,1
2017-7-14,28,83,15033,79,30,-49
2017-7-15,28,72,15076,43,32,-11
2017-7-16,28,86,15076,0,14,14
2017-7-17,29,102,15077,1,17,16
2017-7-18,29,73,15137,60,31,-29
2017-7-19,29,78,15160,23,28,5
2017-7-20,29,86,15188,28,36,8
2017-7-21,29,93,15213,25,32,7
2017-7-22,29,84,15244,31,22,-9
2017-7-23,29,95,15251,7,18,11
2017-7-24,30,111,15254,3,19,16
2017-7-25,30,72,15312,58,19,-39
2017-7-26,30,84,15332,20,32,12
2017-7-27,30,96,15352,20,32,12
2017-7-28,30,98,15370,18,20,2
2017-7-29,30,97,15390,20,19,-1
2017-7-30,30,104,15390,0,7,7
2017-7-31,31,115,15393,3,14,11
2017-8-1,31,103,15417,24,12,-12
2017-8-2,31,96,15453,36,29,-7
2017-8-3,31,86,15487,34,24,-10
2017-8-4,31,90,15500,13,17,4
2017-8-5,31,88,15525,25,23,-2
2017-8-6,31,105,15526,1,18,17
2017-8-7,32,115,15528,2,12,10
2017-8-8,32,153,15534,6,44,38
2017-8-9,32,98,15626,92,37,-55
2017-8-10,32,100,15653,27,29,2
2017-8-11,32,115,15681,28,43,15
2017-8-12,32,123,15700,19,27,8
2017-8-13,32,130,15701,1,8,7
2017-8-14,33,149,15702,1,20,19
2017-8-15,33,64,15813,111,26,-85
2017-8-16,33,91,15833,20,47,27
2017-8-17,33,81,15872,39,29,-10
2017-8-18,33,107,15900,28,54,26
2017-8-19,33,94,15941,41,28,-13
2017-8-20,33,91,15949,8,5,-3
2017-8-21,34,108,15952,3,20,17
2017-8-22,34,136,15975,23,51,28
2017-8-23,34,101,16037,62,27,-35
2017-8-24,34,103,16065,28,30,2
2017-8-25,34,110,16090,25,32,7
2017-8-26,34,122,16095,5,17,12
2017-8-27,34,123,16104,9,10,1
2017-8-28,35,132,16108,4,13,9
2017-8-29,35,121,16145,37,26,-11
2017-8-30,35,117,16177,32,28,-4
2017-8-31,35,111,16205,28,22,-6
2017-9-1,35,122,16210,5,16,11
2017-9-2,35,137,16214,4,19,15
2017-9-3,35,146,16215,1,10,9
2017-9-4,36,154,16216,1,9,8
2017-9-5,36,165,16218,2,13,11
2017-9-6,36,156,16246,28,19,-9
2017-9-7,36,122,16291,45,11,-34
2017-9-8,36,97,16337,46,21,-25
2017-9-9,36,100,16352,15,18,3
2017-9-10,36,95,16363,11,6,-5
2017-9-11,37,88,16379,16,9,-7
2017-9-12,37,102,16383,4,18,14
2017-9-13,37,112,16387,4,14,10
2017-9-14,37,128,16395,8,24,16
2017-9-15,37,102,16450,55,29,-26
2017-9-16,37,101,16466,16,15,-1
2017-9-17,37,109,16466,0,8,8
2017-9-18,38,125,16470,4,20,16
2017-9-19,38,148,16484,14,37,23
2017-9-20,38,130,16529,45,27,-18
2017-9-21,38,136,16545,16,22,6
2017-9-22,38,139,16566,21,24,3
2017-9-23,38,138,16578,12,11,-1
2017-9-24,38,143,16580,2,7,5
2017-9-25,39,154,16580,0,11,11
2017-9-26,39,89,16670,90,25,-65
2017-9-27,39,69,16722,52,32,-20
2017-9-28,39,76,16746,24,31,7
2017-9-29,39,94,16752,6,24,18
2017-9-30,39,122,16752,0,28,28
2017-10-1,39,136,16754,2,16,14
2017-10-2,40,146,16756,2,12,10
2017-10-3,40,108,16826,70,32,-38
2017-10-4,40,128,16844,18,38,20
2017-10-5,40,124,16872,28,24,-4
2017-10-6,40,138,16886,14,28,14
2017-10-7,40,131,16925,39,32,-7
2017-10-8,40,146,16926,1,16,15
2017-10-9,41,159,16927,1,14,13
2017-10-10,41,130,16981,54,25,-29
2017-10-11,41,130,17006,25,25,0
2017-10-12,41,133,17032,26,29,3
2017-10-13,41,131,17056,24,22,-2
2017-10-14,41,134,17081,25,28,3
2017-10-15,41,144,17084,3,13,10
2017-10-16,42,151,17086,2,9,7
2017-10-17,42,104,17155,69,22,-47
2017-10-18,42,107,17189,34,37,3
2017-10-19,42,119,17212,23,35,12
2017-10-20,42,121,17238,26,28,2
2017-10-21,42,130,17258,20,29,9
2017-10-22,42,149,17263,5,24,19
2017-10-23,43,191,17272,9,51,42
2017-10-24,43,107,17431,159,75,-84
2017-10-25,43,115,17463,32,40,8
2017-10-26,43,122,17483,20,27,7
2017-10-27,43,131,17510,27,36,9
2017-10-28,43,123,17541,31,23,-8
2017-10-29,43,131,17541,0,8,8
2017-10-30,44,137,17543,2,8,6
2017-10-31,44,141,17563,20,24,4
2017-11-1,44,147,17580,17,23,6
2017-11-2,44,163,17586,6,22,16
2017-11-3,44,184,17587,1,22,21
2017-11-4,44,168,17622,35,19,-16
2017-11-5,44,168,17629,7,7,0
2017-11-6,45,173,17634,5,10,5
2017-11-7,45,185,17657,23,35,12
2017-11-8,45,166,17698,41,22,-19
2017-11-9,45,181,17703,5,20,15
2017-11-10,45,171,17740,37,27,-10
2017-11-11,45,158,17781,41,28,-13
2017-11-12,45,165,17791,10,17,7
2017-11-13,46,173,17799,8,16,8
2017-11-14,46,163,17841,42,32,-10
2017-11-15,46,123,17900,59,19,-40
2017-11-16,46,126,17932,32,35,3
2017-11-17,46,125,17955,23,22,-1
2017-11-18,46,124,17970,15,14,-1
2017-11-19,46,136,17971,1,13,12
2017-11-20,47,150,17973,2,16,14
2017-11-21,47,167,17975,2,19,17
2017-11-22,47,143,18014,39,15,-24
2017-11-23,47,125,18046,32,14,-18
2017-11-24,47,134,18048,2,11,9
2017-11-25,47,149,18048,0,15,15
2017-11-26,47,163,18049,1,15,14
2017-11-27,48,178,18049,0,15,15
2017-11-28,48,169,18081,32,23,-9
2017-11-29,48,170,18103,22,23,1
2017-11-30,48,192,18114,11,33,22
2017-12-1,48,205,18122,8,21,13
2017-12-2,48,161,18185,63,19,-44
2017-12-3,48,171,18186,1,11,10
2017-12-4,49,186,18186,0,15,15
2017-12-5,49,193,18205,19,26,7
2017-12-6,49,212,18210,5,24,19
2017-12-7,49,183,18263,53,24,-29
2017-12-8,49,197,18265,2,16,14
2017-12-9,49,206,18271,6,15,9
2017-12-10,49,219,18272,1,14,13
2017-12-11,50,231,18276,4,16,12
2017-12-12,50,153,18373,97,19,-78
2017-12-13,50,169,18381,8,24,16
2017-12-14,50,141,18434,53,25,-28
2017-12-15,50,153,18451,17,29,12
2017-12-16,50,171,18456,5,23,18
2017-12-17,50,179,18456,0,8,8
2017-12-18,51,187,18457,1,9,8
2017-12-19,51,201,18465,8,22,14
2017-12-20,51,208,18502,37,44,7
2017-12-21,51,247,18530,28,67,39
2017-12-22,51,287,18546,16,56,40
2017-12-23,51,259,18584,38,10,-28
2017-12-24,51,268,18588,4,13,9
2017-12-25,52,271,18590,2,5,3
2017-12-26,52,281,18591,1,11,10
2017-12-27,52,293,18591,0,12,12
2017-12-28,52,254,18639,48,9,-39
2017-12-29,52,178,18731,92,16,-76
2017-12-30,52,192,18749,18,32,14
2017-12-31,52,199,18750,1,8,7
2018-1-1,53,208,18750,0,9,9
2018-1-2,53,212,18751,1,5,4
2018-1-3,53,92,18890,139,19,-120
2018-1-4,53,43,18962,72,23,-49
2018-1-5,53,40,18985,23,20,-3
2018-1-6,53,37,19012,27,24,-3
2018-1-7,53,43,19016,4,10,6
2018-1-8,54,44,19026,10,11,1
2018-1-9,54,48,19050,24,28,4
2018-1-10,54,53,19065,15,20,5
2018-1-11,54,50,19092,27,24,-3
2018-1-12,54,52,19101,9,11,2
2018-1-13,54,63,19121,20,31,11
2018-1-14,54,76,19123,2,15,13
2018-1-15,55,93,19124,1,18,17
2018-1-16,55,120,19126,2,29,27
2018-1-17,55,148,19135,9,37,28
2018-1-18,55,83,19225,90,25,-65
2018-1-19,55,80,19253,28,25,-3
2018-1-20,55,91,19265,12,23,11
2018-1-21,55,103,19270,5,17,12
2018-1-22,56,113,19271,1,11,10
2018-1-23,56,122,19282,11,20,9
2018-1-24,56,83,19346,64,25,-39
2018-1-25,56,72,19382,36,25,-11
2018-1-26,56,71,19406,24,23,-1
2018-1-27,56,66,19427,21,16,-5
2018-1-28,56,72,19433,6,12,6
2018-1-29,57,77,19433,0,5,5
2018-1-30,57,71,19464,31,25,-6
2018-1-31,57,71,19486,22,22,0
2018-2-1,57,73,19511,25,27,2
2018-2-2,57,72,19535,24,23,-1
2018-2-3,57,78,19550,15,21,6
2018-2-4,57,90,19550,0,12,12
2018-2-5,58,101,19550,0,11,11
2018-2-6,58,124,19556,6,29,23
2018-2-7,58,135,19564,8,19,11
2018-2-8,58,139,19585,21,25,4
2018-2-9,58,147,19596,11,19,8
2018-2-10,58,161,19599,3,17,14
2018-2-11,58,152,19620,21,12,-9
2018-2-12,59,154,19622,2,4,2
2018-2-13,59,156,19645,23,25,2
2018-2-14,59,114,19716,71,29,-42
2018-2-15,59,132,19718,2,20,18
2018-2-16,59,115,19766,48,31,-17
2018-2-17,59,123,19792,26,34,8
2018-2-18,59,140,19795,3,20,17
2018-2-19,60,133,19809,14,7,-7
2018-2-20,60,138,19817,8,13,5
2018-2-21,60,161,19824,7,30,23
2018-2-22,60,185,19829,5,29,24
2018-2-23,60,198,19840,11,24,13
2018-2-24,60,212,19845,5,19,14
2018-2-25,60,220,19847,2,10,8
2018-2-26,61,236,19848,1,17,16
2018-2-27,61,184,19921,73,21,-52
2018-2-28,61,204,19931,10,30,20
2018-3-1,61,182,19973,42,20,-22
2018-3-2,61,157,20018,45,20,-25
2018-3-3,61,161,20043,25,29,4
2018-3-4,61,171,20047,4,14,10
2018-3-5,62,174,20049,2,5,3
2018-3-6,62,162,20083,34,22,-12
2018-3-7,62,159,20107,24,21,-3
2018-3-8,62,149,20132,25,15,-10
2018-3-9,62,134,20167,35,20,-15
2018-3-10,62,142,20187,20,28,8
2018-3-11,62,156,20187,0,14,14
2018-3-12,63,166,20189,2,12,10
2018-3-13,63,182,20191,2,18,16
2018-3-14,63,198,20196,5,21,16
2018-3-15,63,211,20202,6,19,13
2018-3-16,63,152,20286,84,25,-59
2018-3-17,63,142,20313,27,17,-10
2018-3-18,63,148,20314,1,7,6
2018-3-19,64,159,20314,0,11,11
2018-3-20,64,183,20317,3,27,24
2018-3-21,64,189,20337,20,26,6
2018-3-22,64,180,20361,24,15,-9
2018-3-23,64,179,20377,16,15,-1
2018-3-24,64,166,20415,38,25,-13
2018-3-25,64,173,20417,2,9,7
2018-3-26,65,180,20422,5,12,7
2018-3-27,65,158,20461,39,17,-22
2018-3-28,65,144,20501,40,26,-14
2018-3-29,65,138,20525,24,18,-6
2018-3-30,65,138,20547,22,22,0
2018-3-31,65,149,20557,10,21,11
2018-4-1,65,159,20558,1,11,10
2018-4-2,66,165,20558,0,6,6
2018-4-3,66,175,20564,6,16,10
2018-4-4,66,141,20613,49,15,-34
2018-4-5,66,146,20629,16,21,5
2018-4-6,66,154,20642,13,21,8
2018-4-7,66,164,20658,16,26,10
2018-4-8,66,175,20658,0,11,11
2018-4-9,67,196,20660,2,23,21
2018-4-10,67,61,20825,165,30,-135
2018-4-11,67,65,20847,22,26,4
2018-4-12,67,65,20883,36,36,0
2018-4-13,67,67,20901,18,20,2
2018-4-14,67,70,20919,18,21,3
2018-4-15,67,59,20941,22,11,-11
2018-4-16,68,71,20942,1,13,12
2018-4-17,68,65,20977,35,29,-6
2018-4-18,68,54,21017,40,29,-11
2018-4-19,68,59,21044,27,32,5
2018-4-20,68,70,21068,24,35,11
2018-4-21,68,69,21093,25,24,-1
2018-4-22,68,83,21096,3,17,14
2018-4-23,69,100,21096,0,17,17
2018-4-24,69,117,21097,1,18,17
2018-4-25,69,77,21172,75,35,-40
2018-4-26,69,84,21196,24,31,7
2018-4-27,69,74,21241,45,35,-10
2018-4-28,69,65,21266,25,16,-9
2018-4-29,69,75,21267,1,11,10
2018-4-30,70,85,21269,2,12,10
2018-5-1,70,98,21286,17,30,13
2018-5-2,70,88,21317,31,21,-10
2018-5-3,70,104,21328,11,27,16
2018-5-4,70,86,21369,41,23,-18
2018-5-5,70,74,21394,25,13,-12
2018-5-6,70,80,21396,2,8,6
2018-5-7,71,92,21398,2,14,12
2018-5-8,71,38,21465,67,13,-54
2018-5-9,71,49,21492,27,38,11
2018-5-10,71,63,21514,22,36,14
2018-5-11,71,60,21534,20,17,-3
2018-5-12,71,65,21549,15,20,5
2018-5-13,71,75,21550,1,11,10
2018-5-14,72,89,21551,1,15,14
2018-5-15,72,87,21579,28,26,-2
2018-5-16,72,85,21602,23,21,-2
2018-5-17,72,89,21618,16,20,4
2018-5-18,72,111,21623,5,27,22
2018-5-19,72,85,21665,42,16,-26
2018-5-20,72,90,21665,0,5,5
2018-5-21,73,105,21665,0,15,15
2018-5-22,73,106,21684,19,20,1
2018-5-23,73,109,21702,18,21,3
2018-5-24,73,120,21723,21,32,11
2018-5-25,73,146,21730,7,33,26
2018-5-26,73,158,21736,6,18,12
2018-5-27,73,144,21761,25,11,-14
2018-5-28,74,140,21776,15,11,-4
2018-5-29,74,157,21781,5,22,17
2018-5-30,74,140,21832,51,34,-17
2018-5-31,74,158,21839,7,25,18
2018-6-1,74,97,21924,85,24,-61
2018-6-2,74,91,21955,31,25,-6
2018-6-3,74,107,21955,0,16,16
2018-6-4,75,113,21963,8,14,6
2018-6-5,75,102,21994,31,20,-11
2018-6-6,75,98,22029,35,31,-4
2018-6-7,75,94,22058,29,25,-4
2018-6-8,75,106,22067,9,21,12
2018-6-9,75,117,22078,11,22,11
2018-6-10,75,127,22082,4,14,10
2018-6-11,76,139,22086,4,16,12
2018-6-12,76,142,22120,34,37,3
2018-6-13,76,175,22122,2,35,33
2018-6-14,76,144,22180,58,27,-31
2018-6-15,76,167,22183,3,26,23
2018-6-16,76,162,22210,27,22,-5
2018-6-17,76,169,22212,2,9,7
2018-6-18,77,180,22215,3,14,11
2018-6-19,77,148,22272,57,25,-32
2018-6-20,77,120,22325,53,25,-28
2018-6-21,77,75,22398,73,28,-45
2018-6-22,77,63,22432,34,22,-12
2018-6-23,77,68,22449,17,22,5
2018-6-24,77,82,22449,0,14,14
2018-6-25,78,96,22451,2,16,14
2018-6-26,78,86,22499,48,38,-10
2018-6-27,78,68,22540,41,23,-18
2018-6-28,78,79,22558,18,29,11
2018-6-29,78,81,22583,25,27,2
2018-6-30,78,70,22615,32,21,-11
2018-7-1,78,70,22618,3,3,0
2018-7-2,79,76,22620,2,8,6
2018-7-3,79,56,22671,51,31,-20
2018-7-4,79,45,22707,36,25,-11
2018-7-5,79,62,22708,1,18,17
2018-7-6,79,53,22748,40,31,-9
2018-7-7,79,55,22771,23,25,2
2018-7-8,79,67,22771,0,12,12
2018-7-9,80,76,22772,1,10,9
2018-7-10,80,55,22807,35,14,-21
2018-7-11,80,67,22814,7,19,12
2018-7-12,80,69,22835,21,23,2
2018-7-13,80,78,22860,25,34,9
2018-7-14,80,84,22880,20,26,6
2018-7-15,80,95,22885,5,16,11
2018-7-16,81,79,22921,36,20,-16
2018-7-17,81,110,22928,7,38,31
2018-7-18,81,130,22930,2,22,20
2018-7-19,81,145,22936,6,21,15
2018-7-20,81,155,22941,5,15,10
2018-7-21,81,101,23023,82,28,-54
2018-7-22,81,104,23025,2,5,3
2018-7-23,82,114,23030,5,15,10
2018-7-24,82,61,23113,83,30,-53
2018-7-25,82,74,23133,20,33,13
2018-7-26,82,83,23151,18,27,9
2018-7-27,82,91,23176,25,33,8
2018-7-28,82,71,23210,34,14,-20
2018-7-29,82,77,23211,1,7,6
2018-7-30,83,84,23215,4,11,7
2018-7-31,83,62,23280,65,43,-22
2018-8-1,83,68,23303,23,29,6
2018-8-2,83,84,23339,36,52,16
2018-8-3,83,84,23364,25,25,0
2018-8-4,83,82,23401,37,35,-2
2018-8-5,83,87,23403,2,7,5
2018-8-6,84,94,23404,1,8,7
2018-8-7,84,75,23454,50,31,-19
2018-8-8,84,93,23461,7,25,18
2018-8-9,84,86,23489,28,21,-7
2018-8-10,84,91,23511,22,27,5
2018-8-11,84,114,23517,6,29,23
2018-8-12,84,122,23519,2,10,8
2018-8-13,85,124,23522,3,5,2
2018-8-14,85,115,23557,35,26,-9
2018-8-15,85,107,23588,31,23,-8
2018-8-16,85,128,23595,7,28,21
2018-8-17,85,98,23642,47,17,-30
2018-8-18,85,90,23667,25,17,-8
2018-8-19,85,97,23667,0,7,7
2018-8-20,86,104,23668,1,8,7
2018-8-21,86,119,23678,10,25,15
2018-8-22,86,122,23700,22,25,3
2018-8-23,86,119,23731,31,28,-3
2018-8-24,86,129,23748,17,27,10
2018-8-25,86,101,23797,49,21,-28
2018-8-26,86,110,23810,13,22,9
2018-8-27,87,115,23822,12,17,5
2018-8-28,87,111,23847,25,21,-4
2018-8-29,87,118,23884,37,44,7
2018-8-30,87,108,23924,40,30,-10
2018-8-31,87,118,23940,16,26,10
2018-9-1,87,89,23989,49,20,-29
2018-9-2,87,96,23990,1,8,7
2018-9-3,88,106,23991,1,11,10
2018-9-4,88,121,23994,3,18,15
2018-9-5,88,128,24006,12,19,7
2018-9-6,88,117,24039,33,22,-11
2018-9-7,88,129,24053,14,26,12
2018-9-8,88,112,24093,40,23,-17
2018-9-9,88,120,24097,4,12,8
2018-9-10,89,127,24099,2,9,7
2018-9-11,89,90,24162,63,26,-37
2018-9-12,89,102,24179,17,29,12
2018-9-13,89,135,24184,5,38,33
2018-9-14,89,124,24225,41,30,-11
2018-9-15,89,98,24273,48,22,-26
2018-9-16,89,110,24275,2,14,12
2018-9-17,90,97,24297,22,9,-13
2018-9-18,90,96,24332,35,34,-1
2018-9-19,90,85,24376,44,33,-11
2018-9-20,90,84,24405,29,28,-1
2018-9-21,90,97,24428,23,36,13
2018-9-22,90,101,24465,37,41,4
2018-9-23,90,106,24467,2,7,5
2018-9-24,91,114,24469,2,10,8
2018-9-25,91,92,24515,46,24,-22
2018-9-26,91,83,24549,34,25,-9
2018-9-27,91,67,24578,29,13,-16
2018-9-28,91,82,24600,22,37,15
2018-9-29,91,80,24623,23,21,-2
2018-9-30,91,90,24623,0,10,10
2018-10-1,92,102,24623,0,12,12
2018-10-2,92,90,24673,50,38,-12
2018-10-3,92,97,24703,30,37,7
2018-10-4,92,102,24723,20,25,5
2018-10-5,92,105,24751,28,31,3
2018-10-6,92,102,24777,26,23,-3
2018-10-7,92,114,24782,5,17,12
2018-10-8,93,128,24785,3,17,14
2018-10-9,93,102,24832,47,21,-26
2018-10-10,93,77,24889,57,32,-25
2018-10-11,93,69,24931,42,34,-8
2018-10-12,93,73,24958,27,31,4
2018-10-13,93,71,24978,20,18,-2
2018-10-14,93,75,24983,5,9,4
2018-10-15,94,91,24985,2,18,16
2018-10-16,94,78,25039,54,41,-13
2018-10-17,94,76,25067,28,26,-2
2018-10-18,94,83,25089,22,29,7
2018-10-19,94,80,25119,30,27,-3
2018-10-20,94,89,25136,17,26,9
2018-10-21,94,97,25138,2,10,8
2018-10-22,95,113,25139,1,17,16
2018-10-23,95,104,25170,31,22,-9
2018-10-24,95,120,25176,6,22,16
2018-10-25,95,133,25193,17,30,13
2018-10-26,95,141,25204,11,19,8
2018-10-27,95,142,25223,19,20,1
2018-10-28,95,135,25243,20,13,-7
2018-10-29,96,148,25249,6,19,13
2018-10-30,96,150,25263,14,16,2
2018-10-31,96,144,25296,33,27,-6
2018-11-1,96,161,25310,14,31,17
2018-11-2,96,123,25376,66,28,-38
2018-11-3,96,134,25384,8,19,11
2018-11-4,96,137,25391,7,10,3
2018-11-5,97,116,25421,30,9,-21
2018-11-6,97,103,25465,44,31,-13
2018-11-7,97,92,25504,39,28,-11
2018-11-8,97,97,25526,22,27,5
2018-11-9,97,104,25550,24,31,7
2018-11-10,97,123,25558,8,27,19
2018-11-11,97,131,25560,2,10,8
2018-11-12,98,140,25562,2,11,9
2018-11-13,98,153,25571,9,22,13
2018-11-14,98,160,25591,20,27,7
2018-11-15,98,149,25624,33,22,-11
2018-11-16,98,161,25646,22,34,12
2018-11-17,98,167,25664,18,24,6
2018-11-18,98,181,25667,3,17,14
2018-11-19,99,147,25727,60,26,-34
2018-11-20,99,154,25743,16,23,7
2018-11-21,99,129,25793,50,25,-25
2018-11-22,99,122,25832,39,32,-7
2018-11-23,99,129,25838,6,13,7
2018-11-24,99,145,25842,4,20,16
2018-11-25,99,152,25842,0,7,7
2018-11-26,100,169,25846,4,21,17
2018-11-27,100,176,25868,22,29,7
2018-11-28,100,190,25877,9,23,14
2018-11-29,100,164,25935,58,32,-26
2018-11-30,100,165,25956,21,22,1
2018-12-1,100,172,25971,15,22,7
2018-12-2,100,179,25973,2,9,7
2018-12-3,101,190,25988,15,26,11
2018-12-4,101,147,26052,64,21,-43
2018-12-5,101,148,26094,42,43,1
2018-12-6,101,142,26131,37,31,-6
2018-12-7,101,148,26153,22,28,6
2018-12-8,101,118,26208,55,25,-30
2018-12-9,101,135,26208,0,17,17
2018-12-10,102,154,26215,7,26,19
2018-12-11,102,169,26228,13,28,15
2018-12-12,102,189,26238,10,30,20
2018-12-13,102,202,26275,37,50,13
2018-12-14,102,206,26304,29,33,4
2018-12-15,102,206,26324,20,20,0
2018-12-16,102,227,26328,4,25,21
2018-12-17,103,253,26331,3,29,26
2018-12-18,103,168,26447,116,31,-85
2018-12-19,103,114,26529,82,28,-54
2018-12-20,103,98,26565,36,20,-16
2018-12-21,103,93,26588,23,18,-5
2018-12-22,103,89,26611,23,19,-4
2018-12-23,103,100,26612,1,12,11
2018-12-24,104,112,26612,0,12,12
2018-12-25,104,74,26688,76,38,-38
2018-12-26,104,65,26725,37,28,-9
2018-12-27,104,78,26731,6,19,13
2018-12-28,104,89,26737,6,17,11
2018-12-29,104,108,26739,2,21,19
2018-12-30,104,132,26739,0,24,24
2018-12-31,105,139,26741,2,9,7
2019-1-1,105,70,26834,93,24,-69
2019-1-2,105,74,26840,6,10,4
2019-1-3,105,54,26879,39,19,-20
2019-1-4,105,54,26903,24,24,0
2019-1-5,105,52,26923,20,18,-2
2019-1-6,105,62,26923,0,10,10
2019-1-7,106,71,26931,8,17,9
2019-1-8,106,73,26950,19,21,2
2019-1-9,106,93,26951,1,21,20
2019-1-10,106,118,26956,5,30,25
2019-1-11,106,141,26964,8,31,23
2019-1-12,106,149,26970,6,14,8
2019-1-13,106,163,26970,0,14,14
2019-1-14,107,188,26971,1,26,25
2019-1-15,107,180,27007,36,28,-8
2019-1-16,107,190,27039,32,42,10